111111111111111111
1000C111100V0C0001
100C000C00011100C1
100100010001001101
100011100011011001
100000000000000001
1010000000C100V001
1P0001111100100001
100011E0000010C111
111111111111111111